1;1;0;0;0;0;0;0;0;0;0;0;6;3
1;1;2;0;0;1;0;0;0;1;1;0;6;6
1;1;1;1;1;1;1;1;0;0;1;0;0;1
0;1;0;0;0;2;1;0;0;2;1;1;0;0
0;0;0;0;0;1;1;0;0;1;2;0;1;0
0;1;1;1;0;0;0;0;1;0;0;0;0;0
0;1;0;0;2;1;1;0;0;0;0;1;0;0
0;1;0;0;1;1;1;1;0;1;1;1;0;0
0;1;1;0;1;1;1;1;0;1;2;1;1;0
0;0;0;0;1;1;1;2;0;0;0;1;0;0
1;0;0;0;0;0;0;0;1;0;0;1;0;0
0;0;0;0;0;1;0;0;1;0;0;1;2;0
5;5;0;0;0;1;1;1;1;0;1;1;1;1
4;5;0;1;0;0;0;0;0;0;0;1;1;1
