1;1;0;0;0;0;0;0;0;0;0;0;5;3
1;1;2;0;0;1;0;0;0;1;1;0;5;5
1;1;1;1;1;1;1;1;0;0;1;0;0;0
0;1;0;0;0;2;1;0;0;2;1;1;1;0
0;0;0;0;0;1;1;0;0;1;2;0;1;0
0;1;1;1;0;0;0;0;1;0;0;0;0;0
0;1;0;0;2;1;1;0;0;0;0;1;0;0
0;1;0;0;1;1;1;1;0;1;1;1;0;0
0;1;1;0;1;1;1;1;0;1;2;1;1;0
0;0;0;0;1;1;1;2;0;0;0;1;0;0
0;0;1;0;0;0;0;0;1;0;0;1;0;0
1;0;0;1;0;1;0;0;1;0;0;1;2;0
6;6;0;0;0;1;1;1;1;0;1;1;1;1
4;6;1;0;0;0;0;0;0;0;0;1;1;1
