1;1;1;0;0;0;1;0;0;2;1;0;0;0;2;1;0;0;1;0;0;0;0;0;0;0;0;0;1;1
1;1;1;0;0;0;1;0;1;1;1;0;0;0;1;1;0;0;1;0;0;1;1;1;1;0;6;6;6;1
1;1;1;0;0;0;1;0;0;0;1;1;0;0;0;0;0;0;1;0;0;0;0;0;0;0;0;3;6;0
0;1;1;2;0;0;0;1;0;1;0;0;0;1;0;0;1;0;0;0;1;0;0;1;1;1;1;0;6;0
0;1;1;1;0;0;0;1;2;1;0;0;0;1;0;1;1;0;0;0;1;1;1;1;0;2;1;0;0;0
0;0;0;0;1;0;0;0;1;0;0;1;1;0;0;0;0;1;0;0;0;0;0;0;0;0;1;0;1;0
0;0;0;0;0;1;0;0;0;0;0;0;1;0;1;0;0;1;0;1;0;0;1;1;0;1;1;0;1;0
0;1;0;0;0;0;1;0;0;1;1;0;1;0;1;1;0;1;0;1;1;0;1;1;0;1;0;0;1;0
0;1;0;0;0;0;0;1;0;0;1;0;1;0;1;1;0;1;0;1;0;0;0;0;0;1;0;0;1;0
0;1;0;0;0;1;0;0;1;0;1;0;1;0;1;1;2;1;0;0;0;0;1;0;0;0;0;0;0;0
0;1;1;1;2;1;0;0;0;0;1;2;1;1;0;0;1;1;0;0;0;1;1;1;1;0;0;0;0;0
0;0;1;2;1;1;0;0;0;0;1;1;2;1;0;0;0;0;1;1;0;0;0;0;0;0;0;1;1;1
0;0;1;0;1;0;0;0;1;1;0;0;0;1;0;1;0;0;0;0;1;1;0;0;0;0;0;1;2;0
2;0;1;0;0;0;0;1;1;0;0;1;1;1;0;1;1;1;0;0;0;1;1;0;0;0;0;0;0;0
1;1;1;1;1;0;1;1;1;0;1;0;0;1;0;0;1;0;0;1;0;1;1;1;0;1;1;1;1;1
1;1;1;1;1;0;1;1;1;0;1;0;0;1;0;0;1;0;0;1;0;1;1;1;0;1;1;1;1;1
0;0;0;0;0;0;0;1;1;0;0;0;1;1;1;0;1;1;1;0;0;1;1;0;0;0;0;1;0;2
0;2;1;0;0;0;0;0;1;1;0;0;0;0;1;0;1;0;0;0;1;1;0;0;0;1;0;1;0;0
1;1;1;0;0;0;0;0;0;0;1;1;0;0;0;0;1;2;1;1;0;0;0;0;1;1;2;1;0;0
0;0;0;0;0;1;1;1;1;0;0;0;1;1;0;0;1;1;2;1;0;0;0;0;1;2;1;1;1;0
0;0;0;0;0;0;0;1;0;0;0;0;1;2;1;1;0;1;0;1;0;1;0;0;1;0;0;0;1;0
0;1;0;0;1;0;0;0;0;0;1;0;1;0;1;1;0;1;0;1;0;0;1;0;0;0;0;0;1;0
0;1;0;0;1;0;1;1;0;1;1;0;1;0;1;1;0;1;0;1;1;0;0;1;0;0;0;0;1;0
0;1;0;1;1;0;1;1;0;0;1;0;1;0;0;1;0;1;0;0;0;0;0;0;1;0;0;0;0;0
0;1;0;1;0;0;0;0;0;0;0;0;1;0;0;0;0;1;1;0;0;1;0;0;0;1;0;0;0;0
0;0;0;1;2;0;1;1;1;1;0;0;0;1;1;0;1;0;0;0;1;2;1;0;0;0;1;1;1;0
0;5;0;1;1;1;1;0;0;1;0;0;0;1;0;0;1;0;0;0;1;0;1;0;0;0;2;1;1;0
0;5;4;0;0;0;0;0;0;0;0;1;0;0;0;0;0;0;1;1;0;0;0;1;0;0;0;1;1;1
1;5;5;5;0;1;1;1;1;0;0;1;0;0;1;1;0;0;0;1;1;1;0;1;0;0;0;1;1;1
1;1;0;0;0;0;0;0;0;0;0;1;0;0;1;2;0;0;0;1;2;0;0;1;0;0;0;1;1;1
